R 500 500
NO ./textures/sand.xpm

SO ./textures/1.xpm

WE ./textures/2.xpm
EA ./textures/3.xpm
S     ./textures/barrel.xpm
F       4,     75,4,
C  3,  3,           149

    111111111111
  111111111111
1111N000001
100000011111
11111111
