R 2000 2000

NO ./textures/sand.xpm
SO ./textures/1.xpm
WE ./textures/2.xpm
EA ./textures/3.xpm
S ./textures/barrel.xpm
F 4   ,   75  ,    4

C 3   ,  3,   149


lS99z9k1yer1CYH
IS99z9k1yer1CYH

1111111111111
111122000001
100010001111
120002221
10N000001
100112221
100110001
100000001
111111111
