R 2000 200031
NO ./textures/sand.xpm

SO ./textures/1.xpm

WE ./textures/2.xpm
EA ./textures/3.xpm
S     ./textures/barrel.xpm
F 4,75,4

C  3, 3,149

111111111111
111111111111
111122000001
100000011111
120000221
10S0000001
100112221
100112221
100112221
100112221
100112221
100112221
100112221
100110001
100000001
111111111

