R 55000 5000
NO ./textures/sand.xpm

SO ./textures/1.xpm

WE ./textures/2.xpm
EA ./textures/3.xpm
S     ./textures/barrel.xpm
F       4,     75,4,
C  3,  3,           149

1111111111111111111111111111111111111111
      12200000000000000000000000000000001
      10000100020002222222222222222222221
      12002220000002222222222222222222221
11111110000000111000000000222222222222221
10011222000000000002222222222222222222221
10011000000000002000000000000000001111111
100000000000000S0000000000000000001
1111111111111111111111111111111111
