R 1000 1000

NO ./textures/1.xpm
SO ./textures/planks.xpm
WE ./textures/sand.xpm
EA ./textures/woolsnow.xpm
S ./textures/barrel.xpm
F 220   ,   100  ,    0

C 255   ,  30,   30




1111111111111
111122000001
100010001111
120002221
10N000001
100112221
100110001
100000001
111111111
