R 640 480

NO ../textures/bricks.xpm
SO ../textures/planks.xpm
WE ../textures/sand.xpm
EA ../textures/woolsnow.xpm
S ../textures/barrel.xpm
F 220,100,0
C 225,30,0
012345678
1111111111111111111111111111111111
12200000000000000000000000000000001
10001000000000000000000000000000001
12000222000000000000000000000000001
10N00000111000000000000000000000001
10011222000000000000000000000000001
100110000000000000000000000000000001
10000000000000000000000000000000001
11111111111111111111111111111111111
