R 6400 4800

NO ../textures/sand.xpm
SO ../textures/1.xpm
WE ../textures/2.xpm
EA ../textures/3.xpm
S ../textures/barrel.xpm
F 192,  192,    192
C    204    , 204   ,255

1111111111111111111111111111111111111111
      12200000000000000000000000000000001
      100N0100000000000000000000000000001
      1200222000000000000000000000000001
11111110000000111000000000000000000000001
10011222000000000000000000000000011111111
10011000000000000000000000000000001
10000000000000000000000000000000001
1111111111111111111111111111111111