R 640 480

NO ../textures/ls.xpm
SO ../textures/planks.xpm
WE ../textures/sand.xpm
EA ../textures/woolsnow.xpm
S ../textures/barrel.xpm
F 220,100,0
C 225,30,0
012345678
11111111
122000001
100010001
120002221
10N0000011112
100112221
100110001
10000001
11111111
