R 640 480

NO ../textures/bricks.xpm
SO ../textures/planks.xpm
WE ../textures/sand.xpm
EA ../textures/woolsnow.xpm
S ../textures/barrel.xpm
F 220,100,0
C 225,30,0
012345678
11111111
120000001
120010001
100000001
1N0000001
100110201
100110001
100000001
11111111