R 6400 4800

NO ../textures/sand.xpm
SO ../textures/1.xpm
WE ../textures/2.xpm
EA ../textures/3.xpm
S ../textures/barrel.xpm
F 192,  192,    192
C    204    , 204   ,255

1111111111111111111111111111111111111111
      12200000000000000000000000000000001
      100N0100000002222222222222222222221
      12002220000002222222222222222222221
11111110000000111002222222222222222222221
10011222000000000002222222222222222222221
10011000000000000000000000000000001
10000000000000000000000000000000001
1111111111111111111111111111111111