R 6400 4800

NO      ../textures/1.xpm
SO ../textures/planks.xpm
WE ../textures/sand.xpm
EA ../textures/woolsnow.xpm
S ../textures/barrel.xpm
F 220,  100,    33
C    225    ,30   ,0

11111111111111111111111111111111111111111
      12200000000000000000000000000000001
      100N0100000000000000000000000000001
      1200222000000000000000000000000001
11111110000000111000000000000000000000001
10011222000000000000000000000000011111111
10011000000000000000000000000000001
10000000000000000000000000000000001
11111111111111111111111111111111111

